#
# (If you can't read this text on your phone, 
# try cranking down the font size...)
# 
# __   __            __  __           _      ____                _                   _   
# \ \ / /__  _   _  |  \/  |_   _ ___| |_   / ___|___  _ __  ___| |_ _ __ _   _  ___| |_ 
#  \ V / _ \| | | | | |\/| | | | / __| __| | |   / _ \| '_ \/ __| __| '__| | | |/ __| __|
#   | | (_) | |_| | | |  | | |_| \__ \ |_  | |__| (_) | | | \__ \ |_| |  | |_| | (__| |_ 
#   |_|\___/ \__,_| |_| _|_|\__,_|___/\__|  \____\___/|_| |_|___/\__|_|   \__,_|\___|\__|
#
#    / \   __| | __| (_) |_(_) ___  _ __   __ _| | |  _ \ _   _| | ___  _ __  ___| |     
#   / _ \ / _` |/ _` | | __| |/ _ \| '_ \ / _` | | | |_) | | | | |/ _ \| '_ \/ __| |     
#  / ___ \ (_| | (_| | | |_| | (_) | | | | (_| | | |  __/| |_| | | (_) | | | \__ \_|     
# /_/   \_\__,_|\__,_|_|\__|_|\___/|_| |_|\__,_|_| |_|    \__, |_|\___/|_| |_|___(_)     
#                                                         |___/                          
#

{{ if eq .Site.Params.Env "dev" }}
#
# Keep crawlers out of the dev site.
#
User-agent: *
Disallow: /
{{ else }}
#
# Crawlers are welcome here!
#
User-agent: *
Allow: /
{{ end }}


